11111111
11414111
11131111
11212111
11111111